111111111
110000001
100000CC1
1P1111101
111111111