111111111
110000001
100000CE1
1P11111e1
111111111